cccccccccccccccccc
c                c
c                c
c                c
c                c
c                c
c                c
c                c
c                c
c                c
c                c
c                c
c                c
c                c
c                c
c                c
mmmmmmm    mmmmmmm
m                m
m                m
m                m
m                m
m                m
m                m
m                m
m                m
m                m
m                m
m                m
m                m
m                m
m                m
m                m
ppppppp    ppppppp
p                p
p                p
p                p
p                p
p                p
p                p
p                p
p                p
p                p
p                p
p                p
p                p
p                p
p                p
p                p
ooooooo    ooooooo
o                o
o                o
o                o
o                o
o                o
o                o
o                o
o                o
o                o
o                o
o                o
o                o
o                o
o                o
o                o
ggggggg    ggggggg
g                g
g                g
g                g
g                g
g                g
g                g
g                g
g                g
g                g
g                g
g                g
g                g
g                g
g                g
g                g
ggggggg    ggggggg
